===Layout===

#######
#G    #
#     #
#     #
#  @  #
#     #
#     #
#E   @#
#######

===Abstraction===

#######
#31111#
#11111#
#11111#
#11211#
#11111#
#11111#
#11112#
#######

1:garage
2:button
3:cookie
4:almost

===Behaviour===

#######
#11111#
#11111#
#11111#
#11211#
#11211#
#11211#
#22222#
#######

1-up-[up:0.4, down:0.6]
1-left-[left:0.4, down:0.6]
1-right-[right:0.4, down:0.6]
2-up-[up:0.4, down:0.6]