===Layout===

#########################################################
#                                             GGGGG     #
#                                             GGGGG     #
#                                                       #
#                                                       #
#                                                       #
#                                                       #
#                                                       #
#                                                       #
#                                                       #
#                                                       #
#                                                       #
#                                                       #
#                                                       #
#                                                       #
#                                                       #
#                      E                                #
#                                                       #
#                                                       #
#                                                       #
#########################################################

===Abstraction===

#########################################################
#5555555555555555555555111111111111111111111118888811111#
#5555555555555555555558111111111111111111111118888811111#
#5555555555555555555555111111111111111111111111111111111#
#5555555555555555555555111111111111111111111111111111111#
#5555555555555555555555444444455555555555555555555555555#
#5555555555555555555555444444455555555555555555555555555#
#5555555555555555555555444444455555555555555555555555555#
#5555555555555555555555444444455555555555555555555555555#
#5555555555555555555555444444455555555555555555555555555#
#5555555555555555555555333333355555555555555555555555555#
#1111111111111111111111133333222222222222222222222222222#
#1111111111111111111111133333222222222222222222222222222#
#1111111222222222222222233333222222222222222222111111111#
#1111111222222222222222233333222222222222222222111111111#
#1111111222222222222222233333222222222222222222111111111#
#1111111111111111111111111111111111111111111111111111111#
#1111111111111111111111111111111111111111111111111111111#
#1111111111111111111111111111111111111111111111111111111#
#1111111111111111111111111111111111111111111111111111111#
#########################################################

8:nether
1:grass
2:sand
3:cobblestone
4:bridge
5:river

===Rewards===

#########################################################
#wwwwwwwwwwwwwwwwwww                        c           #
#wwwwwwwwwwwwwwwwwww                                    #
#wwwwwwwwwwwwwwwwwww             c                      #
#wwwwwwwwwwwwwwwwwwww                                   #
#wwwwwwwwwwwwwwwwwwww         wwwwwwwwwwwwwwwwwwwwwwwwww#
#wwwwwwwwwwwwwwwwwwww         wwwwwwwwwwwwwwwwwwwwwwwwww#
#wwwwwwwwwwwwwwwwwwww      a  wwwwwwwwwwwwwwwwwwwwwwwwww#
#wwwwwwwwwwwwwwwwwwww         wwwwwwwwwwwwwwwwwwwwwwwwww#
#wwwwwwwwwwwwwwwwwwww         wwwwwwwwwwwwwwwwwwwwwwwwww#
#wwwwwwwwwwwwwwwwwwww         wwwwwwwwwwwwwwwwwwwwwwwwww#
#                                                       #
#                           b            a              #
#                                                       #
#                a                                      #
#                                                       #
#                                    c                  #
#                                                       #
#                                                       #
#                                                       #
#########################################################

a:10
b:15
c:20
w:-10