===Layout===

###############
#E            #
############# #
############# #
############# #
######G       #
###############


===Abstraction===

###############
#1111111111112#
#############1#
#############1#
#############1#
######41111113#
###############

===Rewards===

###############
#            a#
############# #
############# #
############# #
######G      a#
###############

a:10