===Layout===

##########
#E     ###
###### ###
##G### ###
## ### ###
## ### ###
##     ###
##########



===Abstraction===

##########
#111111###
######1###
##5###1###
##1###1###
##1###1###
##11111###
##########
