===Layout===

##########
#E     ###
###### ###
###### ###
###    #G#
### #### #
###      #
##########



===Abstraction===

##########
#111111###
######1###
######1###
###1113#2#
###1####1#
###111111#
##########
