===Layout===

###########
#         #
#      #  #
#    ###  #
# E#   # G#
#  #      #
###########

===Abstraction===

###########
#CCAAAAAAB#
#CCACBB#BB#
#CABA###CB#
#CC#ABB#AH#
#AC#ACCABB#
###########

===Behaviour===

###########
# 1 2 3   #
#  1   #2 #
#1 23### 3#
# 1#3 1# G#
#22#12231 #
###########

1-down-[left:0.8, right:0.2]
1-right-[right:0.75, left:0.25]
2-left-[left:0.6, right:0.4]
2-up-[right:0.85, left:0.15]
3-left-[left:0.5, right:0.5]
3-right-[right:0.75, left:0.25]