#######
#22211#
#23#11#
#22#11#
#######