#########
#   #   #
#  1D  E#
# 2 #   #
##D######
#   # G #
# 3 D 4 #
#   #   #
#########