#######
#     #
#  #  #
#G # E#
#######