###########
#         #
#      #  #
#    ###  #
# E#   # G#
#  #      #
###########