#########
#   #   #
#   D  E#
#   #   #
##D######
#   #G  #
#   D   #
#   #   #
#########