###########
#         #
#      #  #
#    ###  #
# E#   # G#
#  #   #  #
###########