##################################
#111111111#####1111111111####1111#
#22222#2222222222222##444444444###
#33333333333#5555555##333333333###
##################################