##################################
#      1  #####    3     #### G  #
#  E  #      2      ##   4   5 ###
#           #       ##         ###
##################################