#########
#111#222#
#111D222#
#111#222#
##D######
#333#444#
#333D444#
#333#444#
#########