##################################
#         #####          #### G  #
#  E  #             ##         ###
#           #       ##         ###
##################################